PLAYER_ID,PLAYER_NAME_LAST_FIRST,SORT_ORDER,GP,G,SHOT_TYPE,FGA_FREQUENCY,FGM,FGA,FG_PCT,EFG_PCT,FG2A_FREQUENCY,FG2M,FG2A,FG2_PCT,FG3A_FREQUENCY,FG3M,FG3A,FG3_PCT
203991,"Capela, Clint",1,55,55,Overall,1.0,218,390,0.559,0.559,0.997,218,389,0.56,0.003,0,1,0.0
203992,"Bogdanović, Bogdan",1,24,24,Overall,1.0,83,224,0.371,0.469,0.348,39,78,0.5,0.652,44,146,0.301
1626204,"Nance Jr., Larry",1,24,24,Overall,1.0,80,155,0.516,0.626,0.51,46,79,0.582,0.49,34,76,0.447
1629027,"Young, Trae",1,76,76,Overall,1.0,566,1376,0.411,0.491,0.533,348,734,0.474,0.467,218,642,0.34
1629631,"Hunter, De'Andre",1,37,37,Overall,1.0,226,489,0.462,0.56,0.497,130,243,0.535,0.503,96,246,0.39
1629726,"Mathews, Garrison",1,47,45,Overall,1.0,102,257,0.397,0.562,0.152,17,39,0.436,0.848,85,218,0.39
1630168,"Okongwu, Onyeka",1,74,74,Overall,1.0,388,684,0.567,0.602,0.784,340,536,0.634,0.216,48,148,0.324
1630249,"Krejčí, Vít",1,57,54,Overall,1.0,145,292,0.497,0.651,0.295,55,86,0.64,0.705,90,206,0.437
1630552,"Johnson, Jalen",1,36,36,Overall,1.0,269,537,0.501,0.542,0.741,225,398,0.565,0.259,44,139,0.317
1630700,"Daniels, Dyson",1,76,76,Overall,1.0,455,923,0.493,0.536,0.745,375,688,0.545,0.255,80,235,0.34
1630811,"Wallace, Keaton",1,31,28,Overall,1.0,65,162,0.401,0.485,0.494,38,80,0.475,0.506,27,82,0.329
1631230,"Barlow, Dominick",1,35,30,Overall,1.0,60,113,0.531,0.562,0.761,53,86,0.616,0.239,7,27,0.259
1642258,"Risacher, Zaccharie",1,75,75,Overall,1.0,357,780,0.458,0.536,0.559,235,436,0.539,0.441,122,344,0.355
201143,"Horford, Al",1,60,59,Overall,1.0,192,456,0.421,0.543,0.322,81,147,0.551,0.678,111,309,0.359
201950,"Holiday, Jrue",1,62,62,Overall,1.0,250,563,0.444,0.538,0.467,144,263,0.548,0.533,106,300,0.353
204001,"Porziņģis, Kristaps",1,42,41,Overall,1.0,268,556,0.482,0.574,0.556,166,309,0.537,0.444,102,247,0.413
1627759,"Brown, Jaylen",1,63,62,Overall,1.0,512,1105,0.463,0.516,0.677,396,748,0.529,0.323,116,357,0.325
1628369,"Tatum, Jayson",1,72,71,Overall,1.0,651,1442,0.451,0.538,0.501,402,723,0.556,0.499,249,719,0.346
1628401,"White, Derrick",1,76,76,Overall,1.0,424,959,0.442,0.58,0.279,159,268,0.593,0.721,265,691,0.384
1628436,"Kornet, Luke",1,73,66,Overall,1.0,186,279,0.667,0.667,0.989,186,276,0.674,0.011,0,3,0.0
1628470,"Craig, Torrey",1,17,14,Overall,1.0,16,45,0.356,0.456,0.311,7,14,0.5,0.689,9,31,0.29
1630202,"Pritchard, Payton",1,80,79,Overall,1.0,408,860,0.474,0.622,0.278,154,239,0.644,0.722,254,621,0.409
1630573,"Hauser, Sam",1,71,69,Overall,1.0,211,469,0.45,0.624,0.16,48,75,0.64,0.84,163,394,0.414
1631248,"Scheierman, Baylor",1,31,26,Overall,1.0,39,110,0.355,0.473,0.255,13,28,0.464,0.745,26,82,0.317
202684,"Thompson, Tristan",1,40,30,Overall,1.0,31,71,0.437,0.437,0.958,31,68,0.456,0.042,0,3,0.0
1628378,"Mitchell, Donovan",1,71,71,Overall,1.0,585,1320,0.443,0.531,0.52,352,687,0.512,0.48,233,633,0.368
1628386,"Allen, Jarrett",1,82,82,Overall,1.0,452,640,0.706,0.706,0.992,452,635,0.712,0.008,0,5,0.0
1629622,"Strus, Max",1,50,50,Overall,1.0,165,373,0.442,0.594,0.214,52,80,0.65,0.786,113,293,0.386
1629631,"Hunter, De'Andre",1,27,27,Overall,1.0,131,270,0.485,0.596,0.478,71,129,0.55,0.522,60,141,0.426
1629636,"Garland, Darius",1,75,75,Overall,1.0,554,1174,0.472,0.562,0.549,342,645,0.53,0.451,212,529,0.401
1629731,"Wade, Dean",1,59,59,Overall,1.0,112,271,0.413,0.561,0.181,32,49,0.653,0.819,80,222,0.36
1629750,"Green, Javonte",1,18,15,Overall,1.0,23,63,0.365,0.429,0.476,15,30,0.5,0.524,8,33,0.242
1630171,"Okoro, Isaac",1,55,55,Overall,1.0,124,267,0.464,0.569,0.434,68,116,0.586,0.566,56,151,0.371
1630241,"Merrill, Sam",1,71,70,Overall,1.0,172,424,0.406,0.567,0.132,35,56,0.625,0.868,137,368,0.372
1630596,"Mobley, Evan",1,71,71,Overall,1.0,505,906,0.557,0.604,0.746,420,676,0.621,0.254,85,230,0.37
203468,"McCollum, CJ",1,56,56,Overall,1.0,444,1000,0.444,0.53,0.541,273,541,0.505,0.459,171,459,0.373
203482,"Olynyk, Kelly",1,20,20,Overall,1.0,75,150,0.5,0.547,0.76,61,114,0.535,0.24,14,36,0.389
1627749,"Murray, Dejounte",1,31,31,Overall,1.0,194,493,0.394,0.446,0.647,142,319,0.445,0.353,52,174,0.299
1628964,"Bamba, Mo",1,4,4,Overall,1.0,4,9,0.444,0.444,0.556,4,5,0.8,0.444,0,4,0.0
1628971,"Brown, Bruce",1,23,23,Overall,1.0,73,178,0.41,0.455,0.747,57,133,0.429,0.253,16,45,0.356
1629627,"Williamson, Zion",1,30,30,Overall,1.0,288,508,0.567,0.57,0.974,285,495,0.576,0.026,3,13,0.231
1630526,"Robinson-Earl, Jeremiah",1,66,63,Overall,1.0,158,347,0.455,0.536,0.527,102,183,0.557,0.473,56,164,0.341
1630527,"Boston, Brandon",1,42,40,Overall,1.0,165,379,0.435,0.5,0.631,116,239,0.485,0.369,49,140,0.35
1630529,"Jones, Herbert",1,20,20,Overall,1.0,75,172,0.436,0.5,0.581,53,100,0.53,0.419,22,72,0.306
1630530,"Murphy III, Trey",1,53,52,Overall,1.0,381,839,0.454,0.548,0.478,223,401,0.556,0.522,158,438,0.361
1630631,"Alvarado, Jose",1,56,56,Overall,1.0,204,521,0.392,0.498,0.407,93,212,0.439,0.593,111,309,0.359
1631255,"Matković, Karlo",1,42,38,Overall,1.0,135,235,0.574,0.619,0.719,114,169,0.675,0.281,21,66,0.318
1631288,"Cain, Jamal",1,37,32,Overall,1.0,68,158,0.43,0.513,0.494,42,78,0.538,0.506,26,80,0.325
1641722,"Hawkins, Jordan",1,56,56,Overall,1.0,207,556,0.372,0.471,0.403,97,224,0.433,0.597,110,332,0.331
1641810,"Reeves, Antonio",1,44,41,Overall,1.0,113,248,0.456,0.558,0.48,62,119,0.521,0.52,51,129,0.395
1641998,"Jemison III, Trey",1,16,15,Overall,1.0,15,32,0.469,0.469,1.0,15,32,0.469,0.0,0,0,
1642274,"Missi, Yves",1,73,71,Overall,1.0,269,491,0.548,0.548,0.998,269,490,0.549,0.002,0,1,0.0
202696,"Vučević, Nikola",1,73,73,Overall,1.0,550,1038,0.53,0.592,0.691,421,717,0.587,0.309,129,321,0.402
203897,"LaVine, Zach",1,42,42,Overall,1.0,363,710,0.511,0.607,0.57,227,405,0.56,0.43,136,305,0.446
1628366,"Ball, Lonzo",1,35,35,Overall,1.0,89,243,0.366,0.504,0.198,22,48,0.458,0.802,67,195,0.344
1628975,"Carter, Jevon",1,36,32,Overall,1.0,55,146,0.377,0.497,0.281,20,41,0.488,0.719,35,105,0.333
1629632,"White, Coby",1,74,74,Overall,1.0,508,1121,0.453,0.55,0.479,292,537,0.544,0.521,216,584,0.37
1629659,"Horton-Tucker, Talen",1,58,48,Overall,1.0,133,291,0.457,0.527,0.581,92,169,0.544,0.419,41,122,0.336
1630172,"Williams, Patrick",1,63,63,Overall,1.0,205,516,0.397,0.49,0.473,109,244,0.447,0.527,96,272,0.353
1630188,"Smith, Jalen",1,64,63,Overall,1.0,190,408,0.466,0.554,0.456,118,186,0.634,0.544,72,222,0.324
1630245,"Dosunmu, Ayo",1,46,46,Overall,1.0,221,449,0.492,0.561,0.579,159,260,0.612,0.421,62,189,0.328
1630537,"Duarte, Chris",1,17,14,Overall,1.0,12,26,0.462,0.577,0.423,6,11,0.545,0.577,6,15,0.4
1630581,"Giddey, Josh",1,70,70,Overall,1.0,366,791,0.463,0.528,0.652,262,516,0.508,0.348,104,275,0.378
1631207,"Terry, Dalen",1,73,66,Overall,1.0,120,268,0.448,0.517,0.612,83,164,0.506,0.388,37,104,0.356
1641763,"Phillips, Julian",1,79,73,Overall,1.0,128,287,0.446,0.533,0.467,78,134,0.582,0.533,50,153,0.327
1641824,"Buzelis, Matas",1,80,78,Overall,1.0,252,555,0.454,0.541,0.521,156,289,0.54,0.479,96,266,0.361
202681,"Irving, Kyrie",1,50,50,Overall,1.0,447,945,0.473,0.549,0.62,303,586,0.517,0.38,144,359,0.401
202691,"Thompson, Klay",1,72,72,Overall,1.0,361,877,0.412,0.535,0.369,145,324,0.448,0.631,216,553,0.391
202693,"Morris, Markieff",1,7,6,Overall,1.0,5,22,0.227,0.273,0.409,3,9,0.333,0.591,2,13,0.154
203915,"Dinwiddie, Spencer",1,79,77,Overall,1.0,284,682,0.416,0.496,0.522,175,356,0.492,0.478,109,326,0.334
203939,"Powell, Dwight",1,55,28,Overall,1.0,42,61,0.689,0.705,0.918,40,56,0.714,0.082,2,5,0.4
203957,"Exum, Danté",1,20,20,Overall,1.0,64,134,0.478,0.563,0.604,41,81,0.506,0.396,23,53,0.434
1628467,"Kleber, Maxi",1,34,29,Overall,1.0,37,96,0.385,0.453,0.49,24,47,0.511,0.51,13,49,0.265
1628997,"Martin, Caleb",1,14,14,Overall,1.0,28,72,0.389,0.417,0.778,24,56,0.429,0.222,4,16,0.25
1629023,"Washington, P.J.",1,57,57,Overall,1.0,301,665,0.453,0.521,0.641,210,426,0.493,0.359,91,239,0.381
1629029,"Dončić, Luka",1,22,22,Overall,1.0,216,466,0.464,0.544,0.545,141,254,0.555,0.455,75,212,0.354
1629655,"Gafford, Daniel",1,57,57,Overall,1.0,283,403,0.702,0.702,1.0,283,403,0.702,0.0,0,0,
1629656,"Grimes, Quentin",1,47,46,Overall,1.0,169,365,0.463,0.573,0.449,89,164,0.543,0.551,80,201,0.398
1630230,"Marshall, Naji",1,69,69,Overall,1.0,362,712,0.508,0.551,0.694,302,494,0.611,0.306,60,218,0.275
1630314,"Williams, Brandon",1,33,29,Overall,1.0,98,188,0.521,0.585,0.681,74,128,0.578,0.319,24,60,0.4
1630556,"Edwards, Kessler",1,40,30,Overall,1.0,67,135,0.496,0.578,0.6,45,81,0.556,0.4,22,54,0.407
1630702,"Hardy, Jaden",1,57,54,Overall,1.0,180,413,0.436,0.528,0.523,104,216,0.481,0.477,76,197,0.386
1631108,"Christie, Max",1,32,32,Overall,1.0,124,302,0.411,0.502,0.5,69,151,0.457,0.5,55,151,0.364
1641726,"Lively II, Dereck",1,36,36,Overall,1.0,134,191,0.702,0.702,1.0,134,191,0.702,0.0,0,0,
1641765,"Prosper, Olivier-Maxence",1,52,43,Overall,1.0,70,174,0.402,0.437,0.707,58,123,0.472,0.293,12,51,0.235
201566,"Westbrook, Russell",1,75,75,Overall,1.0,365,814,0.448,0.504,0.654,275,532,0.517,0.346,90,282,0.319
201599,"Jordan, DeAndre",1,56,51,Overall,1.0,91,139,0.655,0.655,1.0,91,139,0.655,0.0,0,0,
203967,"Šarić, Dario",1,16,14,Overall,1.0,21,56,0.375,0.438,0.554,14,31,0.452,0.446,7,25,0.28
203999,"Jokić, Nikola",1,70,70,Overall,1.0,786,1363,0.577,0.627,0.758,648,1033,0.627,0.242,138,330,0.418
1627750,"Murray, Jamal",1,67,67,Overall,1.0,523,1106,0.473,0.543,0.646,368,714,0.515,0.354,155,392,0.395
1628427,"Čančar, Vlatko",1,13,8,Overall,1.0,10,26,0.385,0.462,0.423,6,11,0.545,0.577,4,15,0.267
1629008,"Porter Jr., Michael",1,77,76,Overall,1.0,523,1035,0.505,0.598,0.534,332,553,0.6,0.466,191,482,0.396
1629618,"Pickett, Jalen",1,49,43,Overall,1.0,77,180,0.428,0.539,0.439,37,79,0.468,0.561,40,101,0.396
1630192,"Nnaji, Zeke",1,57,45,Overall,1.0,70,139,0.504,0.565,0.626,53,87,0.609,0.374,17,52,0.327
1631124,"Strawther, Julian",1,65,64,Overall,1.0,202,472,0.428,0.524,0.441,111,208,0.534,0.559,91,264,0.345
1631128,"Braun, Christian",1,79,78,Overall,1.0,471,811,0.581,0.634,0.729,384,591,0.65,0.271,87,220,0.395
1631212,"Watson, Peyton",1,68,68,Overall,1.0,200,420,0.476,0.531,0.683,154,287,0.537,0.317,46,133,0.346
1641725,"Alexander, Trey",1,24,14,Overall,1.0,13,41,0.317,0.354,0.585,10,24,0.417,0.415,3,17,0.176
1641816,"Tyson, Hunter",1,51,40,Overall,1.0,45,120,0.375,0.471,0.383,22,46,0.478,0.617,23,74,0.311
1642461,"Jones, Spencer",1,20,14,Overall,1.0,11,34,0.324,0.338,0.5,10,17,0.588,0.5,1,17,0.059
201939,"Curry, Stephen",1,70,70,Overall,1.0,564,1257,0.449,0.572,0.377,253,474,0.534,0.623,311,783,0.397
202710,"Butler III, Jimmy",1,30,30,Overall,1.0,159,334,0.476,0.504,0.796,140,266,0.526,0.204,19,68,0.279
203110,"Green, Draymond",1,68,68,Overall,1.0,216,509,0.424,0.503,0.517,136,263,0.517,0.483,80,246,0.325
203937,"Anderson, Kyle",1,36,35,Overall,1.0,75,167,0.449,0.506,0.689,56,115,0.487,0.311,19,52,0.365
203952,"Wiggins, Andrew",1,43,43,Overall,1.0,261,588,0.444,0.524,0.578,167,340,0.491,0.422,94,248,0.379
1626172,"Looney, Kevon",1,76,71,Overall,1.0,141,275,0.513,0.516,0.982,139,270,0.515,0.018,2,5,0.4
1627741,"Hield, Buddy",1,82,82,Overall,1.0,328,786,0.417,0.546,0.302,125,237,0.527,0.698,203,549,0.37
1627780,"Payton II, Gary",1,62,61,Overall,1.0,171,298,0.574,0.626,0.681,140,203,0.69,0.319,31,95,0.326
1628995,"Knox II, Kevin",1,14,10,Overall,1.0,18,36,0.5,0.556,0.583,14,21,0.667,0.417,4,15,0.267
1630228,"Kuminga, Jonathan",1,47,47,Overall,1.0,257,567,0.453,0.494,0.734,211,416,0.507,0.266,46,151,0.305
1630311,"Spencer, Pat",1,39,30,Overall,1.0,41,101,0.406,0.431,0.782,36,79,0.456,0.218,5,22,0.227
1630322,"Waters III, Lindy",1,38,37,Overall,1.0,76,203,0.374,0.495,0.281,27,57,0.474,0.719,49,146,0.336
1630541,"Moody, Moses",1,74,74,Overall,1.0,246,568,0.433,0.544,0.407,120,231,0.519,0.593,126,337,0.374
1630611,"Santos, Gui",1,56,48,Overall,1.0,82,179,0.458,0.553,0.425,48,76,0.632,0.575,34,103,0.33
1631218,"Jackson-Davis, Trayce",1,62,54,Overall,1.0,174,302,0.576,0.576,0.99,174,299,0.582,0.01,0,3,0.0
1641764,"Podziemski, Brandin",1,64,63,Overall,1.0,280,629,0.445,0.537,0.509,165,320,0.516,0.491,115,309,0.372
1642366,"Post, Quinten",1,42,41,Overall,1.0,123,274,0.449,0.582,0.347,50,95,0.526,0.653,73,179,0.408
201145,"Green, Jeff",1,32,28,Overall,1.0,61,121,0.504,0.624,0.347,32,42,0.762,0.653,29,79,0.367
203500,"Adams, Steven",1,58,49,Overall,1.0,91,167,0.545,0.545,0.988,91,165,0.552,0.012,0,2,0.0
1627832,"VanVleet, Fred",1,60,60,Overall,1.0,287,759,0.378,0.483,0.393,128,298,0.43,0.607,159,461,0.345
1628415,"Brooks, Dillon",1,75,75,Overall,1.0,384,895,0.429,0.533,0.476,198,426,0.465,0.524,186,469,0.397
1628988,"Holiday, Aaron",1,62,58,Overall,1.0,117,268,0.437,0.571,0.325,45,87,0.517,0.675,72,181,0.398
1629098,"McVeigh, Jack",1,9,6,Overall,1.0,5,17,0.294,0.412,0.235,1,4,0.25,0.765,4,13,0.308
1629111,"Landale, Jock",1,42,35,Overall,1.0,81,152,0.533,0.569,0.829,70,126,0.556,0.171,11,26,0.423
1630224,"Green, Jalen",1,82,82,Overall,1.0,608,1437,0.423,0.505,0.54,374,776,0.482,0.46,234,661,0.354
1630256,"Tate, Jae'Sean",1,52,43,Overall,1.0,70,148,0.473,0.527,0.689,54,102,0.529,0.311,16,46,0.348
1630578,"Sengun, Alperen",1,76,76,Overall,1.0,567,1143,0.496,0.505,0.921,546,1053,0.519,0.079,21,90,0.233
1631095,"Smith Jr., Jabari",1,57,57,Overall,1.0,248,566,0.438,0.525,0.511,150,289,0.519,0.489,98,277,0.354
1631106,"Eason, Tari",1,57,57,Overall,1.0,272,559,0.487,0.543,0.671,209,375,0.557,0.329,63,184,0.342
1631466,"Williams, Nate",1,20,14,Overall,1.0,27,62,0.435,0.484,0.581,21,36,0.583,0.419,6,26,0.231
1641708,"Thompson, Amen",1,69,69,Overall,1.0,388,697,0.557,0.575,0.869,363,606,0.599,0.131,25,91,0.275
1641715,"Whitmore, Cam",1,51,47,Overall,1.0,179,403,0.444,0.525,0.546,114,220,0.518,0.454,65,183,0.355
1642263,"Sheppard, Reed",1,52,46,Overall,1.0,84,239,0.351,0.452,0.406,36,97,0.371,0.594,48,142,0.338
201587,"Batum, Nicolas",1,78,70,Overall,1.0,104,238,0.437,0.622,0.147,16,35,0.457,0.853,88,203,0.433
201935,"Harden, James",1,79,79,Overall,1.0,531,1295,0.41,0.501,0.484,296,627,0.472,0.516,235,668,0.352
202695,"Leonard, Kawhi",1,37,37,Overall,1.0,310,623,0.498,0.56,0.695,232,433,0.536,0.305,78,190,0.411
203992,"Bogdanović, Bogdan",1,30,30,Overall,1.0,127,268,0.474,0.588,0.466,66,125,0.528,0.534,61,143,0.427
1626181,"Powell, Norman",1,60,60,Overall,1.0,457,945,0.484,0.578,0.547,278,517,0.538,0.453,179,428,0.418
1627732,"Simmons, Ben",1,18,16,Overall,1.0,23,53,0.434,0.434,1.0,23,53,0.434,0.0,0,0,
1627739,"Dunn, Kris",1,74,74,Overall,1.0,192,437,0.439,0.525,0.487,117,213,0.549,0.513,75,224,0.335
1627826,"Zubac, Ivica",1,80,80,Overall,1.0,592,940,0.63,0.63,1.0,592,940,0.63,0.0,0,0,
1627884,"Jones Jr., Derrick",1,77,77,Overall,1.0,310,589,0.526,0.593,0.628,232,370,0.627,0.372,78,219,0.356
1628964,"Bamba, Mo",1,28,27,Overall,1.0,48,103,0.466,0.539,0.515,33,53,0.623,0.485,15,50,0.3
1629599,"Coffey, Amir",1,72,69,Overall,1.0,240,510,0.471,0.57,0.516,139,263,0.529,0.484,101,247,0.409
1629611,"Mann, Terance",1,37,37,Overall,1.0,87,195,0.446,0.513,0.615,61,120,0.508,0.385,26,75,0.347
1629645,"Porter Jr., Kevin",1,45,45,Overall,1.0,172,407,0.423,0.455,0.74,146,301,0.485,0.26,26,106,0.245
1630538,"Hyland, Bones",1,20,20,Overall,1.0,45,115,0.391,0.526,0.304,14,35,0.4,0.696,31,80,0.388
1630539,"Jones, Kai",1,28,16,Overall,1.0,26,36,0.722,0.722,0.944,26,34,0.765,0.056,0,2,0.0
1641738,"Brown, Kobe",1,40,27,Overall,1.0,33,72,0.458,0.5,0.639,27,46,0.587,0.361,6,26,0.231
1641757,"Miller, Jordan",1,37,29,Overall,1.0,58,134,0.433,0.463,0.716,50,96,0.521,0.284,8,38,0.211
2544,"James, LeBron",1,70,70,Overall,1.0,651,1270,0.513,0.571,0.688,502,874,0.574,0.312,149,396,0.376
203076,"Davis, Anthony",1,42,42,Overall,1.0,400,758,0.528,0.546,0.876,372,664,0.56,0.124,28,94,0.298
1626156,"Russell, D'Angelo",1,29,29,Overall,1.0,129,311,0.415,0.505,0.46,73,143,0.51,0.54,56,168,0.333
1627827,"Finney-Smith, Dorian",1,43,43,Overall,1.0,122,276,0.442,0.591,0.254,40,70,0.571,0.746,82,206,0.398
1629003,"Milton, Shake",1,30,23,Overall,1.0,42,97,0.433,0.485,0.649,32,63,0.508,0.351,10,34,0.294
1629020,"Vanderbilt, Jarred",1,36,35,Overall,1.0,59,121,0.488,0.525,0.736,50,89,0.562,0.264,9,32,0.281
1629029,"Dončić, Luka",1,28,28,Overall,1.0,245,559,0.438,0.53,0.519,143,290,0.493,0.481,102,269,0.379
1629060,"Hachimura, Rui",1,59,59,Overall,1.0,293,574,0.51,0.599,0.57,191,327,0.584,0.43,102,247,0.413
1629216,"Vincent, Gabe",1,72,69,Overall,1.0,168,420,0.4,0.53,0.264,59,111,0.532,0.736,109,309,0.353
1629629,"Reddish, Cam",1,33,30,Overall,1.0,38,94,0.404,0.473,0.5,25,47,0.532,0.5,13,47,0.277
1629637,"Hayes, Jaxson",1,56,54,Overall,1.0,161,223,0.722,0.722,0.987,161,220,0.732,0.013,0,3,0.0
1630559,"Reaves, Austin",1,73,73,Overall,1.0,477,1037,0.46,0.556,0.488,277,506,0.547,0.512,200,531,0.377
1630692,"Goodwin, Jordan",1,29,28,Overall,1.0,63,144,0.438,0.528,0.528,37,76,0.487,0.472,26,68,0.382
1631108,"Christie, Max",1,46,46,Overall,1.0,128,287,0.446,0.551,0.432,68,124,0.548,0.568,60,163,0.368
1631132,"Koloko, Christian",1,37,25,Overall,1.0,40,66,0.606,0.606,0.939,40,62,0.645,0.061,0,4,0.0
1641721,"Lewis, Maxwell",1,7,3,Overall,1.0,2,6,0.333,0.333,1.0,2,6,0.333,0.0,0,0,
1642261,"Knecht, Dalton",1,78,76,Overall,1.0,257,557,0.461,0.576,0.39,129,217,0.594,0.61,128,340,0.376
1642355,"James, Bronny",1,27,20,Overall,1.0,21,67,0.313,0.381,0.522,12,35,0.343,0.478,9,32,0.281
1642422,"Traoré, Armel",1,9,8,Overall,1.0,6,19,0.316,0.316,0.632,6,12,0.5,0.368,0,7,0.0
1642439,"Olivari, Quincy",1,2,2,Overall,1.0,1,5,0.2,0.3,0.0,0,0,,1.0,1,5,0.2
202710,"Butler III, Jimmy",1,25,24,Overall,1.0,142,263,0.54,0.565,0.863,129,227,0.568,0.137,13,36,0.361
1626179,"Rozier, Terry",1,64,64,Overall,1.0,248,635,0.391,0.462,0.515,157,327,0.48,0.485,91,308,0.295
1628389,"Adebayo, Bam",1,78,78,Overall,1.0,540,1113,0.485,0.521,0.801,461,892,0.517,0.199,79,221,0.357
1629130,"Robinson, Duncan",1,74,74,Overall,1.0,290,663,0.437,0.581,0.271,100,180,0.556,0.729,190,483,0.393
1629312,"Highsmith, Haywood",1,74,71,Overall,1.0,179,390,0.459,0.573,0.405,90,158,0.57,0.595,89,232,0.384
1629639,"Herro, Tyler",1,77,77,Overall,1.0,651,1378,0.472,0.563,0.513,400,707,0.566,0.487,251,671,0.374
1630528,"Christopher, Josh",1,14,10,Overall,1.0,11,31,0.355,0.387,0.645,9,20,0.45,0.355,2,11,0.182
1631107,"Jović, Nikola",1,46,46,Overall,1.0,172,378,0.455,0.558,0.444,94,168,0.56,0.556,78,210,0.371
1631170,"Jaquez Jr., Jaime",1,66,62,Overall,1.0,213,462,0.461,0.501,0.742,176,343,0.513,0.258,37,119,0.311
1641796,"Larsson, Pelle",1,55,46,Overall,1.0,89,203,0.438,0.517,0.532,57,108,0.528,0.468,32,95,0.337
1642276,"Ware, Kel'el",1,64,63,Overall,1.0,257,464,0.554,0.592,0.761,222,353,0.629,0.239,35,111,0.315
201572,"Lopez, Brook",1,80,80,Overall,1.0,394,774,0.509,0.599,0.518,255,401,0.636,0.482,139,373,0.373
203081,"Lillard, Damian",1,58,58,Overall,1.0,444,992,0.448,0.547,0.472,247,468,0.528,0.528,197,524,0.376
203114,"Middleton, Khris",1,23,23,Overall,1.0,108,211,0.512,0.595,0.592,73,125,0.584,0.408,35,86,0.407
203507,"Antetokounmpo, Giannis",1,67,67,Overall,1.0,793,1319,0.601,0.607,0.952,779,1256,0.62,0.048,14,63,0.222
1626171,"Portis, Bobby",1,49,49,Overall,1.0,277,595,0.466,0.52,0.701,212,417,0.508,0.299,65,178,0.365
1626192,"Connaughton, Pat",1,41,37,Overall,1.0,83,177,0.469,0.542,0.542,57,96,0.594,0.458,26,81,0.321
1627752,"Prince, Taurean",1,80,80,Overall,1.0,235,514,0.457,0.6,0.348,88,179,0.492,0.652,147,335,0.439
1629018,"Trent Jr., Gary",1,74,74,Overall,1.0,283,657,0.431,0.568,0.341,103,224,0.46,0.659,180,433,0.416
1630649,"Umude, Stanley",1,22,14,Overall,1.0,5,26,0.192,0.25,0.423,2,11,0.182,0.577,3,15,0.2
1630699,"Beauchamp, MarJon",1,26,20,Overall,1.0,18,47,0.383,0.457,0.553,11,26,0.423,0.447,7,21,0.333
1631157,"Rollins, Ryan",1,56,48,Overall,1.0,132,271,0.487,0.577,0.557,83,151,0.55,0.443,49,120,0.408
1631260,"Green, AJ",1,73,72,Overall,1.0,182,424,0.429,0.612,0.144,27,61,0.443,0.856,155,363,0.427
1641748,"Jackson Jr., Andre",1,67,57,Overall,1.0,94,197,0.477,0.553,0.614,64,121,0.529,0.386,30,76,0.395
1641753,"Livingston, Chris",1,21,12,Overall,1.0,9,27,0.333,0.333,0.704,9,19,0.474,0.296,0,8,0.0
201144,"Conley, Mike",1,71,71,Overall,1.0,187,468,0.4,0.535,0.338,60,158,0.38,0.662,127,310,0.41
203497,"Gobert, Rudy",1,72,72,Overall,1.0,341,510,0.669,0.669,1.0,341,510,0.669,0.0,0,0,
203944,"Randle, Julius",1,69,69,Overall,1.0,455,939,0.485,0.542,0.666,347,625,0.555,0.334,108,314,0.344
1628408,"Dozier, PJ",1,9,3,Overall,1.0,2,3,0.667,1.0,0.0,0,0,,1.0,2,3,0.667
1628978,"DiVincenzo, Donte",1,62,62,Overall,1.0,250,594,0.421,0.567,0.263,76,156,0.487,0.737,174,438,0.397
1629638,"Alexander-Walker, Nickeil",1,82,82,Overall,1.0,270,616,0.438,0.553,0.399,129,246,0.524,0.601,141,370,0.381
1629675,"Reid, Naz",1,80,80,Overall,1.0,426,923,0.462,0.556,0.499,251,461,0.544,0.501,175,462,0.379
1630162,"Edwards, Anthony",1,79,79,Overall,1.0,721,1612,0.447,0.547,0.497,401,801,0.501,0.503,320,811,0.395
1630183,"McDaniels, Jaden",1,82,82,Overall,1.0,398,834,0.477,0.537,0.637,298,531,0.561,0.363,100,303,0.33
1630545,"Shannon Jr., Terrence",1,32,26,Overall,1.0,55,114,0.482,0.531,0.728,44,83,0.53,0.272,11,31,0.355
1630568,"Garza, Luka",1,39,32,Overall,1.0,52,105,0.495,0.543,0.657,42,69,0.609,0.343,10,36,0.278
1631169,"Minott, Josh",1,46,35,Overall,1.0,44,90,0.489,0.567,0.522,30,47,0.638,0.478,14,43,0.326
1641740,"Clark, Jaylen",1,40,35,Overall,1.0,56,120,0.467,0.558,0.575,34,69,0.493,0.425,22,51,0.431
1642265,"Dillingham, Rob",1,49,41,Overall,1.0,93,211,0.441,0.5,0.649,68,137,0.496,0.351,25,74,0.338
1626156,"Russell, D'Angelo",1,29,29,Overall,1.0,120,327,0.367,0.454,0.413,63,135,0.467,0.587,57,192,0.297
1627827,"Finney-Smith, Dorian",1,20,20,Overall,1.0,73,159,0.459,0.607,0.321,26,51,0.51,0.679,47,108,0.435
1629003,"Milton, Shake",1,27,23,Overall,1.0,73,157,0.465,0.554,0.541,45,85,0.529,0.459,28,72,0.389
1629651,"Claxton, Nic",1,70,70,Overall,1.0,320,568,0.563,0.568,0.963,315,547,0.576,0.037,5,21,0.238
1629661,"Johnson, Cameron",1,57,57,Overall,1.0,355,747,0.475,0.582,0.454,196,339,0.578,0.546,159,408,0.39
1630533,"Williams, Ziaire",1,63,63,Overall,1.0,214,520,0.412,0.511,0.419,111,218,0.509,0.581,103,302,0.341
1630549,"Sharpe, Day'Ron",1,50,50,Overall,1.0,165,317,0.521,0.538,0.858,154,272,0.566,0.142,11,45,0.244
1630553,"Johnson, Keon",1,79,79,Overall,1.0,303,779,0.389,0.47,0.485,177,378,0.468,0.515,126,401,0.314
1630560,"Thomas, Cam",1,25,25,Overall,1.0,199,454,0.438,0.513,0.57,131,259,0.506,0.43,68,195,0.349
1630570,"Watford, Trendon",1,44,43,Overall,1.0,164,350,0.469,0.51,0.749,135,262,0.515,0.251,29,88,0.33
1630592,"Wilson, Jalen",1,79,79,Overall,1.0,246,620,0.397,0.495,0.416,124,258,0.481,0.584,122,362,0.337
1631213,"Martin, Tyrese",1,60,58,Overall,1.0,189,465,0.406,0.513,0.394,90,183,0.492,0.606,99,282,0.351
1641727,"Whitehead, Dariq",1,20,15,Overall,1.0,39,96,0.406,0.578,0.229,6,22,0.273,0.771,33,74,0.446
1641730,"Clowney, Noah",1,46,46,Overall,1.0,133,372,0.358,0.474,0.298,46,111,0.414,0.702,87,261,0.333
1641736,"Beekman, Reece",1,34,28,Overall,1.0,34,106,0.321,0.354,0.623,27,66,0.409,0.377,7,40,0.175
1626157,"Towns, Karl-Anthony",1,71,71,Overall,1.0,635,1203,0.528,0.586,0.724,494,871,0.567,0.276,141,332,0.425
1626166,"Payne, Cameron",1,71,71,Overall,1.0,177,439,0.403,0.508,0.426,85,187,0.455,0.574,92,252,0.365
1628384,"Anunoby, OG",1,73,73,Overall,1.0,482,1010,0.477,0.56,0.554,315,560,0.563,0.446,167,450,0.371
1628404,"Hart, Josh",1,76,77,Overall,1.0,402,765,0.525,0.58,0.672,319,514,0.621,0.328,83,251,0.331
1628969,"Bridges, Mikal",1,81,80,Overall,1.0,585,1169,0.5,0.571,0.608,421,711,0.592,0.392,164,458,0.358
1628973,"Brunson, Jalen",1,64,64,Overall,1.0,575,1177,0.489,0.552,0.668,425,786,0.541,0.332,150,391,0.384
1629011,"Robinson, Mitchell",1,16,15,Overall,1.0,34,52,0.654,0.654,1.0,34,52,0.654,0.0,0,0,
1629013,"Shamet, Landry",1,49,47,Overall,1.0,104,228,0.456,0.59,0.32,43,73,0.589,0.68,61,155,0.394
1630173,"Achiuwa, Precious",1,56,56,Overall,1.0,163,325,0.502,0.517,0.889,153,289,0.529,0.111,10,36,0.278
1630540,"McBride, Miles",1,63,63,Overall,1.0,214,535,0.4,0.504,0.428,103,229,0.45,0.572,111,306,0.363
1642278,"Kolek, Tyler",1,41,32,Overall,1.0,27,82,0.329,0.415,0.427,13,35,0.371,0.573,14,47,0.298
202709,"Joseph, Cory",1,50,44,Overall,1.0,62,154,0.403,0.529,0.305,23,47,0.489,0.695,39,107,0.364
203484,"Caldwell-Pope, Kentavious",1,77,76,Overall,1.0,239,544,0.439,0.543,0.393,126,214,0.589,0.607,113,330,0.342
203914,"Harris, Gary",1,48,41,Overall,1.0,51,133,0.383,0.519,0.241,15,32,0.469,0.759,36,101,0.356
1628371,"Isaac, Jonathan",1,71,70,Overall,1.0,134,324,0.414,0.474,0.534,95,173,0.549,0.466,39,151,0.258
1628976,"Carter Jr., Wendell",1,68,68,Overall,1.0,226,491,0.46,0.498,0.678,189,333,0.568,0.322,37,158,0.234
1629048,"Bitadze, Goga",1,70,62,Overall,1.0,207,339,0.611,0.615,0.917,204,311,0.656,0.083,3,28,0.107
1630175,"Anthony, Cole",1,67,66,Overall,1.0,230,543,0.424,0.494,0.599,153,325,0.471,0.401,77,218,0.353
1630532,"Wagner, Franz",1,60,60,Overall,1.0,537,1161,0.463,0.507,0.697,433,809,0.535,0.303,104,352,0.295
1631094,"Banchero, Paolo",1,46,46,Overall,1.0,412,911,0.452,0.5,0.701,325,639,0.509,0.299,87,272,0.32
1631216,"Houstan, Caleb",1,58,50,Overall,1.0,80,190,0.421,0.589,0.158,16,30,0.533,0.842,64,160,0.4
1641710,"Black, Anthony",1,78,77,Overall,1.0,262,621,0.422,0.472,0.686,200,426,0.469,0.314,62,195,0.318
1641783,"da Silva, Tristan",1,74,71,Overall,1.0,199,483,0.412,0.495,0.505,119,244,0.488,0.495,80,239,0.335
204456,"McConnell, T.J.",1,79,78,Overall,1.0,324,624,0.519,0.531,0.921,309,575,0.537,0.079,15,49,0.306
1626167,"Turner, Myles",1,72,72,Overall,1.0,390,811,0.481,0.577,0.514,234,417,0.561,0.486,156,394,0.396
1627783,"Siakam, Pascal",1,78,78,Overall,1.0,613,1182,0.519,0.572,0.726,487,858,0.568,0.274,126,324,0.389
1628418,"Bryant, Thomas",1,56,55,Overall,1.0,151,293,0.515,0.587,0.553,109,162,0.673,0.447,42,131,0.321
1629614,"Nembhard, Andrew",1,65,65,Overall,1.0,247,539,0.458,0.506,0.675,196,364,0.538,0.325,51,175,0.291
1630167,"Toppin, Obi",1,79,78,Overall,1.0,317,599,0.529,0.621,0.497,207,298,0.695,0.503,110,301,0.365
1630169,"Haliburton, Tyrese",1,73,73,Overall,1.0,476,1006,0.473,0.582,0.441,258,444,0.581,0.559,218,562,0.388
1630174,"Nesmith, Aaron",1,45,45,Overall,1.0,192,379,0.507,0.617,0.485,108,184,0.587,0.515,84,195,0.431
1631097,"Mathurin, Bennedict",1,72,72,Overall,1.0,391,853,0.458,0.516,0.662,293,565,0.519,0.338,98,288,0.34
1641716,"Walker, Jarace",1,75,70,Overall,1.0,170,360,0.472,0.576,0.486,95,175,0.543,0.514,75,185,0.405
1641767,"Sheppard, Ben",1,63,61,Overall,1.0,120,287,0.418,0.537,0.307,52,88,0.591,0.693,68,199,0.342
1642484,"Dennis, RayJ",1,11,7,Overall,1.0,11,33,0.333,0.424,0.364,5,12,0.417,0.636,6,21,0.286
200768,"Lowry, Kyle",1,35,32,Overall,1.0,41,117,0.35,0.474,0.248,12,29,0.414,0.752,29,88,0.33
202331,"George, Paul",1,41,41,Overall,1.0,245,570,0.43,0.514,0.53,149,302,0.493,0.47,96,268,0.358
202704,"Jackson, Reggie",1,31,30,Overall,1.0,52,133,0.391,0.485,0.444,27,59,0.458,0.556,25,74,0.338
203083,"Drummond, Andre",1,40,40,Overall,1.0,117,234,0.5,0.506,0.915,114,214,0.533,0.085,3,20,0.15
203954,"Embiid, Joel",1,19,19,Overall,1.0,140,315,0.444,0.481,0.756,117,238,0.492,0.244,23,77,0.299
1626162,"Oubre Jr., Kelly",1,60,60,Overall,1.0,348,741,0.47,0.518,0.673,277,499,0.555,0.327,71,242,0.293
1627824,"Yabusele, Guerschon",1,70,70,Overall,1.0,282,563,0.501,0.593,0.513,178,289,0.616,0.487,104,274,0.38
1628997,"Martin, Caleb",1,31,29,Overall,1.0,101,232,0.435,0.506,0.625,68,145,0.469,0.375,33,87,0.379
1629022,"Walker IV, Lonnie",1,20,19,Overall,1.0,89,212,0.42,0.526,0.401,44,85,0.518,0.599,45,127,0.354
1629052,"Brissett, Oshae",1,6,6,Overall,1.0,19,39,0.487,0.564,0.538,13,21,0.619,0.462,6,18,0.333
1629643,"Okeke, Chuma",1,7,6,Overall,1.0,18,33,0.545,0.697,0.333,8,11,0.727,0.667,10,22,0.455
1629656,"Grimes, Quentin",1,28,28,Overall,1.0,215,458,0.469,0.559,0.52,133,238,0.559,0.48,82,220,0.373
1630178,"Maxey, Tyrese",1,52,52,Overall,1.0,477,1091,0.437,0.511,0.562,316,613,0.515,0.438,161,478,0.337
1630215,"Butler, Jared",1,28,28,Overall,1.0,118,277,0.426,0.507,0.538,73,149,0.49,0.462,45,128,0.352
1630231,"Martin, KJ",1,24,22,Overall,1.0,61,99,0.616,0.657,0.788,53,78,0.679,0.212,8,21,0.381
1641720,"Hood-Schifino, Jalen",1,13,13,Overall,1.0,36,97,0.371,0.443,0.526,22,51,0.431,0.474,14,46,0.304
1641741,"Council IV, Ricky",1,73,69,Overall,1.0,177,463,0.382,0.442,0.54,122,250,0.488,0.46,55,213,0.258
1642348,"Edwards, Justin",1,44,43,Overall,1.0,171,377,0.454,0.544,0.499,103,188,0.548,0.501,68,189,0.36
201142,"Durant, Kevin",1,62,62,Overall,1.0,592,1124,0.527,0.598,0.669,432,752,0.574,0.331,160,372,0.43
203078,"Beal, Bradley",1,53,53,Overall,1.0,345,694,0.497,0.571,0.62,243,430,0.565,0.38,102,264,0.386
203486,"Plumlee, Mason",1,74,64,Overall,1.0,125,202,0.619,0.619,0.98,125,198,0.631,0.02,0,4,0.0
1626145,"Jones, Tyus",1,81,81,Overall,1.0,306,683,0.448,0.57,0.413,140,282,0.496,0.587,166,401,0.414
1626164,"Booker, Devin",1,75,75,Overall,1.0,654,1420,0.461,0.525,0.612,471,869,0.542,0.388,183,551,0.332
1626220,"O'Neale, Royce",1,75,75,Overall,1.0,241,570,0.423,0.58,0.226,62,129,0.481,0.774,179,441,0.406
1628420,"Morris, Monté",1,45,44,Overall,1.0,83,195,0.426,0.505,0.559,52,109,0.477,0.441,31,86,0.36
1628960,"Allen, Grayson",1,64,64,Overall,1.0,219,489,0.448,0.6,0.284,70,139,0.504,0.716,149,350,0.426
1628998,"Martin, Cody",1,14,14,Overall,1.0,20,57,0.351,0.377,0.526,17,30,0.567,0.474,3,27,0.111
1629626,"Bol, Bol",1,36,32,Overall,1.0,96,183,0.525,0.612,0.492,64,90,0.711,0.508,32,93,0.344
1630208,"Richards, Nick",1,36,35,Overall,1.0,141,233,0.605,0.605,0.996,141,232,0.608,0.004,0,1,0.0
1631221,"Gillespie, Collin",1,33,30,Overall,1.0,68,158,0.43,0.554,0.43,29,68,0.426,0.57,39,90,0.433
1641779,"Bridges, Jalen",1,8,6,Overall,1.0,2,7,0.286,0.429,0.0,0,0,,1.0,2,7,0.286
1642345,"Ighodaro, Oso",1,61,52,Overall,1.0,113,187,0.604,0.604,0.989,113,185,0.611,0.011,0,2,0.0
1642346,"Dunn, Ryan",1,74,70,Overall,1.0,204,476,0.429,0.514,0.447,123,213,0.577,0.553,81,263,0.308
203924,"Grant, Jerami",1,47,47,Overall,1.0,214,574,0.373,0.467,0.484,106,278,0.381,0.516,108,296,0.365
1629014,"Simons, Anfernee",1,70,70,Overall,1.0,479,1125,0.426,0.521,0.473,264,532,0.496,0.527,215,593,0.363
1629028,"Ayton, Deandre",1,40,40,Overall,1.0,265,468,0.566,0.573,0.932,259,436,0.594,0.068,6,32,0.188
1629680,"Thybulle, Matisse",1,15,14,Overall,1.0,42,88,0.477,0.597,0.455,21,40,0.525,0.545,21,48,0.438
1630166,"Avdija, Deni",1,72,72,Overall,1.0,402,844,0.476,0.55,0.595,277,502,0.552,0.405,125,342,0.365
1630625,"Banton, Dalano",1,67,61,Overall,1.0,198,507,0.391,0.462,0.562,126,285,0.442,0.438,72,222,0.324
1630703,"Henderson, Scoot",1,66,66,Overall,1.0,287,685,0.419,0.496,0.566,182,388,0.469,0.434,105,297,0.354
1631101,"Sharpe, Shaedon",1,72,72,Overall,1.0,499,1104,0.452,0.519,0.572,352,632,0.557,0.428,147,472,0.311
1631133,"Walker, Jabari",1,60,51,Overall,1.0,118,229,0.515,0.576,0.686,90,157,0.573,0.314,28,72,0.389
1631200,"Murray, Kris",1,69,59,Overall,1.0,117,279,0.419,0.468,0.57,90,159,0.566,0.43,27,120,0.225
1631303,"Minaya, Justin",1,19,9,Overall,1.0,8,21,0.381,0.429,0.524,6,11,0.545,0.476,2,10,0.2
1641712,"Rupert, Rayan",1,52,38,Overall,1.0,58,142,0.408,0.465,0.585,42,83,0.506,0.415,16,59,0.271
1641739,"Camara, Toumani",1,78,78,Overall,1.0,328,716,0.458,0.552,0.497,193,356,0.542,0.503,135,360,0.375
1641871,"Reath, Duop",1,46,40,Overall,1.0,70,166,0.422,0.524,0.361,36,60,0.6,0.639,34,106,0.321
1642270,"Clingan, Donovan",1,67,67,Overall,1.0,180,334,0.539,0.56,0.853,166,285,0.582,0.147,14,49,0.286
201942,"DeRozan, DeMar",1,77,77,Overall,1.0,624,1308,0.477,0.509,0.804,540,1051,0.514,0.196,84,257,0.327
202685,"Valančiūnas, Jonas",1,32,32,Overall,1.0,114,205,0.556,0.559,0.951,113,195,0.579,0.049,1,10,0.1
203109,"Crowder, Jae",1,9,6,Overall,1.0,7,22,0.318,0.409,0.318,3,7,0.429,0.682,4,15,0.267
203458,"Len, Alex",1,36,23,Overall,1.0,22,41,0.537,0.549,0.854,21,35,0.6,0.146,1,6,0.167
203897,"LaVine, Zach",1,32,32,Overall,1.0,262,513,0.511,0.611,0.55,159,282,0.564,0.45,103,231,0.446
203926,"McDermott, Doug",1,42,31,Overall,1.0,50,117,0.427,0.615,0.137,6,16,0.375,0.863,44,101,0.436
1626168,"Lyles, Trey",1,69,68,Overall,1.0,157,374,0.42,0.528,0.364,76,136,0.559,0.636,81,238,0.34
1627734,"Sabonis, Domantas",1,70,69,Overall,1.0,527,893,0.59,0.627,0.825,462,737,0.627,0.175,65,156,0.417
1627746,"Labissiere, Skal",1,4,2,Overall,1.0,2,4,0.5,0.625,0.75,1,3,0.333,0.25,1,1,1.0
1628365,"Fultz, Markelle",1,21,19,Overall,1.0,28,67,0.418,0.448,0.881,24,59,0.407,0.119,4,8,0.5
1628368,"Fox, De'Aaron",1,45,45,Overall,1.0,414,883,0.469,0.521,0.676,322,597,0.539,0.324,92,286,0.322
1628370,"Monk, Malik",1,65,65,Overall,1.0,412,939,0.439,0.513,0.544,273,511,0.534,0.456,139,428,0.325
1628989,"Huerter, Kevin",1,43,43,Overall,1.0,128,310,0.413,0.513,0.339,66,105,0.629,0.661,62,205,0.302
1629162,"McLaughlin, Jordan",1,28,17,Overall,1.0,16,44,0.364,0.477,0.409,6,18,0.333,0.591,10,26,0.385
1630222,"Jones, Mason",1,10,7,Overall,1.0,9,18,0.5,0.528,0.556,8,10,0.8,0.444,1,8,0.125
1631099,"Murray, Keegan",1,76,76,Overall,1.0,364,820,0.444,0.538,0.452,210,371,0.566,0.548,154,449,0.343
1631115,"Robinson, Orlando",1,9,6,Overall,1.0,7,17,0.412,0.441,0.706,6,12,0.5,0.294,1,5,0.2
1631165,"Ellis, Keon",1,80,79,Overall,1.0,227,464,0.489,0.639,0.308,88,143,0.615,0.692,139,321,0.433
1631222,"LaRavia, Jake",1,19,18,Overall,1.0,42,96,0.438,0.542,0.458,22,44,0.5,0.542,20,52,0.385
1641732,"Jones, Colby",1,24,14,Overall,1.0,11,26,0.423,0.5,0.615,7,16,0.438,0.385,4,10,0.4
1642269,"Carter, Devin",1,36,32,Overall,1.0,47,127,0.37,0.441,0.52,29,66,0.439,0.48,18,61,0.295
1642403,"Jones, Isaac",1,40,29,Overall,1.0,54,83,0.651,0.669,0.904,51,75,0.68,0.096,3,8,0.375
101108,"Paul, Chris",1,82,82,Overall,1.0,249,583,0.427,0.547,0.364,109,212,0.514,0.636,140,371,0.377
202687,"Biyombo, Bismack",1,28,26,Overall,1.0,67,114,0.588,0.588,1.0,67,114,0.588,0.0,0,0,
203084,"Barnes, Harrison",1,82,82,Overall,1.0,347,683,0.508,0.622,0.473,191,323,0.591,0.527,156,360,0.433
1628368,"Fox, De'Aaron",1,17,17,Overall,1.0,125,280,0.446,0.493,0.661,99,185,0.535,0.339,26,95,0.274
1628380,"Collins, Zach",1,36,34,Overall,1.0,61,132,0.462,0.515,0.652,47,86,0.547,0.348,14,46,0.304
1629162,"McLaughlin, Jordan",1,18,11,Overall,1.0,15,28,0.536,0.696,0.286,6,8,0.75,0.714,9,20,0.45
1629640,"Johnson, Keldon",1,77,77,Overall,1.0,371,770,0.482,0.538,0.644,284,496,0.573,0.356,87,274,0.318
1629646,"Bassey, Charles",1,36,30,Overall,1.0,68,117,0.581,0.581,1.0,68,117,0.581,0.0,0,0,
1630170,"Vassell, Devin",1,64,64,Overall,1.0,394,889,0.443,0.532,0.517,236,460,0.513,0.483,158,429,0.368
1630200,"Jones, Tre",1,28,28,Overall,1.0,45,93,0.484,0.527,0.72,37,67,0.552,0.28,8,26,0.308
1630561,"Duke Jr., David",1,6,5,Overall,1.0,6,14,0.429,0.536,0.571,3,8,0.375,0.429,3,6,0.5
1630572,"Mamukelashvili, Sandro",1,61,56,Overall,1.0,141,281,0.502,0.609,0.427,81,120,0.675,0.573,60,161,0.373
1630577,"Champagnie, Julian",1,82,82,Overall,1.0,276,665,0.415,0.549,0.278,98,185,0.53,0.722,178,480,0.371
1631103,"Branham, Malaki",1,47,39,Overall,1.0,87,190,0.458,0.547,0.558,53,106,0.5,0.442,34,84,0.405
1631104,"Wesley, Blake",1,58,51,Overall,1.0,81,186,0.435,0.481,0.688,64,128,0.5,0.312,17,58,0.293
1631110,"Sochan, Jeremy",1,54,54,Overall,1.0,251,469,0.535,0.565,0.804,223,377,0.592,0.196,28,92,0.304
1631127,"Ingram, Harrison",1,5,4,Overall,1.0,2,4,0.5,0.5,0.75,2,3,0.667,0.25,0,1,0.0
1631321,"Cissoko, Sidy",1,17,11,Overall,1.0,9,18,0.5,0.583,0.611,6,11,0.545,0.389,3,7,0.429
1641705,"Wembanyama, Victor",1,46,46,Overall,1.0,408,857,0.476,0.559,0.53,266,454,0.586,0.47,142,403,0.352
1642264,"Castle, Stephon",1,81,81,Overall,1.0,423,988,0.428,0.476,0.663,328,655,0.501,0.337,95,333,0.285
1642434,"Minix, Riley",1,1,1,Overall,1.0,0,1,0.0,0.0,0.0,0,0,,1.0,0,1,0.0
1627936,"Caruso, Alex",1,54,53,Overall,1.0,140,314,0.446,0.541,0.459,80,144,0.556,0.541,60,170,0.353
1628392,"Hartenstein, Isaiah",1,57,57,Overall,1.0,278,479,0.58,0.58,0.96,278,460,0.604,0.04,0,19,0.0
1628983,"Gilgeous-Alexander, Shai",1,76,76,Overall,1.0,860,1656,0.519,0.569,0.737,697,1221,0.571,0.263,163,435,0.375
1629026,"Williams, Kenrich",1,69,67,Overall,1.0,171,354,0.483,0.576,0.517,105,183,0.574,0.483,66,171,0.386
1629652,"Dort, Luguentz",1,71,71,Overall,1.0,258,593,0.435,0.578,0.304,88,180,0.489,0.696,170,413,0.412
1630198,"Joe, Isaiah",1,74,74,Overall,1.0,259,588,0.44,0.604,0.207,67,122,0.549,0.793,192,466,0.412
1630598,"Wiggins, Aaron",1,76,75,Overall,1.0,355,728,0.488,0.577,0.534,225,389,0.578,0.466,130,339,0.383
1631096,"Holmgren, Chet",1,32,32,Overall,1.0,167,341,0.49,0.554,0.66,123,225,0.547,0.34,44,116,0.379
1631114,"Williams, Jalen",1,69,69,Overall,1.0,565,1168,0.484,0.537,0.709,441,828,0.533,0.291,124,340,0.365
1631119,"Williams, Jaylin",1,47,47,Overall,1.0,97,221,0.439,0.577,0.308,36,68,0.529,0.692,61,153,0.399
1631172,"Dieng, Ousmane",1,37,33,Overall,1.0,54,125,0.432,0.524,0.432,31,54,0.574,0.568,23,71,0.324
1641717,"Wallace, Cason",1,68,68,Overall,1.0,232,489,0.474,0.55,0.575,158,281,0.562,0.425,74,208,0.356
1641745,"Flagler, Adam",1,37,27,Overall,1.0,25,96,0.26,0.333,0.25,11,24,0.458,0.75,14,72,0.194
1641794,"Jones, Dillon",1,54,40,Overall,1.0,51,133,0.383,0.444,0.526,35,70,0.5,0.474,16,63,0.254
1642349,"Mitchell, Ajay",1,36,34,Overall,1.0,92,185,0.497,0.559,0.676,69,125,0.552,0.324,23,60,0.383
202066,"Temple, Garrett",1,28,18,Overall,1.0,18,60,0.3,0.35,0.533,12,32,0.375,0.467,6,28,0.214
1629628,"Barrett, RJ",1,58,58,Overall,1.0,459,980,0.468,0.523,0.688,352,674,0.522,0.312,107,306,0.35
1630534,"Agbaji, Ochai",1,64,64,Overall,1.0,266,534,0.498,0.593,0.526,165,281,0.587,0.474,101,253,0.399
1630567,"Barnes, Scottie",1,65,65,Overall,1.0,473,1062,0.445,0.481,0.736,397,782,0.508,0.264,76,280,0.271
1630639,"Lawson, A.J.",1,26,25,Overall,1.0,80,190,0.421,0.508,0.468,47,89,0.528,0.532,33,101,0.327
1630658,"Castleton, Colin",1,11,11,Overall,1.0,32,64,0.5,0.516,0.875,30,56,0.536,0.125,2,8,0.25
1631115,"Robinson, Orlando",1,35,34,Overall,1.0,109,244,0.447,0.48,0.807,93,197,0.472,0.193,16,47,0.34
1642266,"Walter, Ja'Kobe",1,52,51,Overall,1.0,159,393,0.405,0.487,0.527,94,207,0.454,0.473,65,186,0.349
1642347,"Shead, Jamal",1,75,74,Overall,1.0,203,503,0.404,0.475,0.557,131,280,0.468,0.443,72,223,0.323
1642367,"Mogbo, Jonathan",1,63,60,Overall,1.0,156,356,0.438,0.462,0.803,139,286,0.486,0.197,17,70,0.243
1642419,"Battle, Jamison",1,59,56,Overall,1.0,149,347,0.429,0.581,0.254,44,88,0.5,0.746,105,259,0.405
201988,"Mills, Patty",1,17,16,Overall,1.0,26,76,0.342,0.454,0.25,9,19,0.474,0.75,17,57,0.298
203903,"Clarkson, Jordan",1,37,37,Overall,1.0,201,492,0.409,0.494,0.53,117,261,0.448,0.47,84,231,0.364
1628374,"Markkanen, Lauri",1,47,47,Overall,1.0,296,700,0.423,0.521,0.43,158,301,0.525,0.57,138,399,0.346
1628381,"Collins, John",1,40,40,Overall,1.0,280,531,0.527,0.583,0.721,221,383,0.577,0.279,59,148,0.399
1629012,"Sexton, Collin",1,63,63,Overall,1.0,416,867,0.48,0.543,0.687,306,596,0.513,0.313,110,271,0.406
1629234,"Eubanks, Drew",1,37,34,Overall,1.0,88,145,0.607,0.617,0.966,85,140,0.607,0.034,3,5,0.6
1630548,"Juzang, Johnny",1,64,64,Overall,1.0,204,475,0.429,0.554,0.339,86,161,0.534,0.661,118,314,0.376
1631117,"Kessler, Walker",1,58,58,Overall,1.0,278,420,0.662,0.669,0.917,272,385,0.706,0.083,6,35,0.171
1641718,"George, Keyonte",1,67,67,Overall,1.0,359,919,0.391,0.485,0.448,185,412,0.449,0.552,174,507,0.343
1641729,"Sensabaugh, Brice",1,71,70,Overall,1.0,275,599,0.459,0.59,0.379,118,227,0.52,0.621,157,372,0.422
1642262,"Williams, Cody",1,50,48,Overall,1.0,83,257,0.323,0.391,0.475,48,122,0.393,0.525,35,135,0.259
1642268,"Collier, Isaiah",1,71,70,Overall,1.0,234,555,0.422,0.459,0.695,192,386,0.497,0.305,42,169,0.249
1642271,"Filipowski, Kyle",1,72,71,Overall,1.0,260,518,0.502,0.576,0.575,183,298,0.614,0.425,77,220,0.35
1628379,"Kennard, Luke",1,64,62,Overall,1.0,203,424,0.479,0.612,0.394,90,167,0.539,0.606,113,257,0.44
1628991,"Jackson Jr., Jaren",1,73,72,Overall,1.0,586,1198,0.489,0.55,0.679,441,814,0.542,0.321,145,384,0.378
1629630,"Morant, Ja",1,49,49,Overall,1.0,395,867,0.456,0.506,0.678,307,588,0.522,0.322,88,279,0.315
1629634,"Clarke, Brandon",1,63,64,Overall,1.0,232,376,0.617,0.618,0.955,231,359,0.643,0.045,1,17,0.059
1629723,"Konchar, John",1,46,33,Overall,1.0,41,91,0.451,0.577,0.319,18,29,0.621,0.681,23,62,0.371
1630205,"Stevens, Lamar",1,17,14,Overall,1.0,29,63,0.46,0.524,0.571,21,36,0.583,0.429,8,27,0.296
1630217,"Bane, Desmond",1,68,68,Overall,1.0,484,1001,0.484,0.565,0.586,320,587,0.545,0.414,164,414,0.396
1630583,"Aldama, Santi",1,64,64,Overall,1.0,308,636,0.484,0.577,0.498,190,317,0.599,0.502,118,319,0.37
1630590,"Pippen Jr., Scotty",1,78,76,Overall,1.0,284,591,0.481,0.554,0.631,197,373,0.528,0.369,87,218,0.399
1630643,"Huff, Jay",1,64,56,Overall,1.0,157,305,0.515,0.648,0.344,76,105,0.724,0.656,81,200,0.405
1631222,"LaRavia, Jake",1,47,47,Overall,1.0,118,241,0.49,0.573,0.627,78,151,0.517,0.373,40,90,0.444
1641713,"Jackson, GG",1,29,28,Overall,1.0,74,199,0.372,0.452,0.523,42,104,0.404,0.477,32,95,0.337
1641744,"Edey, Zach",1,65,65,Overall,1.0,247,428,0.577,0.598,0.879,229,376,0.609,0.121,18,52,0.346
1642285,"Spencer, Cam",1,25,19,Overall,1.0,34,82,0.415,0.53,0.354,15,29,0.517,0.646,19,53,0.358
1642377,"Wells, Jaylen",1,78,78,Overall,1.0,286,672,0.426,0.528,0.423,149,284,0.525,0.577,137,388,0.353
202685,"Valančiūnas, Jonas",1,49,49,Overall,1.0,231,422,0.547,0.556,0.936,224,395,0.567,0.064,7,27,0.259
1626158,"Holmes, Richaun",1,31,31,Overall,1.0,90,139,0.647,0.647,0.978,90,136,0.662,0.022,0,3,0.0
1627763,"Brogdon, Malcolm",1,24,24,Overall,1.0,104,240,0.433,0.467,0.767,88,184,0.478,0.233,16,56,0.286
1628398,"Kuzma, Kyle",1,32,32,Overall,1.0,191,455,0.42,0.469,0.648,146,295,0.495,0.352,45,160,0.281
1629673,"Poole, Jordan",1,68,68,Overall,1.0,457,1056,0.433,0.544,0.411,222,434,0.512,0.589,235,622,0.378
1630551,"Champagnie, Justin",1,62,56,Overall,1.0,210,411,0.511,0.601,0.53,136,218,0.624,0.47,74,193,0.383
1630557,"Kispert, Corey",1,61,61,Overall,1.0,255,565,0.451,0.558,0.416,135,235,0.574,0.584,120,330,0.364
1641731,"Coulibaly, Bilal",1,59,59,Overall,1.0,263,624,0.421,0.472,0.641,200,400,0.5,0.359,63,224,0.281
1641774,"Vukcevic, Tristan",1,35,33,Overall,1.0,120,242,0.496,0.574,0.579,82,140,0.586,0.421,38,102,0.373
1642259,"Sarr, Alex",1,67,67,Overall,1.0,326,828,0.394,0.457,0.588,221,487,0.454,0.412,105,341,0.308
1642267,"Carrington, Bub",1,82,82,Overall,1.0,300,748,0.401,0.493,0.456,162,341,0.475,0.544,138,407,0.339
1642273,"George, Kyshawn",1,68,67,Overall,1.0,203,546,0.372,0.476,0.352,89,192,0.464,0.648,114,354,0.322
202699,"Harris, Tobias",1,73,73,Overall,1.0,384,805,0.477,0.534,0.672,293,541,0.542,0.328,91,264,0.345
203471,"Schröder, Dennis",1,28,28,Overall,1.0,95,250,0.38,0.444,0.576,63,144,0.438,0.424,32,106,0.302
203501,"Hardaway Jr., Tim",1,77,77,Overall,1.0,276,680,0.406,0.529,0.328,108,223,0.484,0.672,168,457,0.368
1627736,"Beasley, Malik",1,82,82,Overall,1.0,460,1069,0.43,0.579,0.285,142,305,0.466,0.715,318,764,0.416
1630191,"Stewart, Isaiah",1,72,69,Overall,1.0,176,315,0.559,0.586,0.832,159,262,0.607,0.168,17,53,0.321
1630194,"Reed, Paul",1,45,38,Overall,1.0,72,142,0.507,0.535,0.803,64,114,0.561,0.197,8,28,0.286
1630322,"Waters III, Lindy",1,14,14,Overall,1.0,16,44,0.364,0.534,0.136,1,6,0.167,0.864,15,38,0.395
1630595,"Cunningham, Cade",1,70,70,Overall,1.0,683,1456,0.469,0.52,0.713,534,1038,0.514,0.287,149,418,0.356
1631105,"Duren, Jalen",1,78,77,Overall,1.0,378,546,0.692,0.692,1.0,378,546,0.692,0.0,0,0,
1631204,"Sasser, Marcus",1,57,52,Overall,1.0,136,295,0.461,0.558,0.488,79,144,0.549,0.512,57,151,0.377
1631323,"Fontecchio, Simone",1,75,74,Overall,1.0,150,373,0.402,0.504,0.391,74,146,0.507,0.609,76,227,0.335
1641709,"Thompson, Ausar",1,59,58,Overall,1.0,246,460,0.535,0.547,0.893,235,411,0.572,0.107,11,49,0.224
1641842,"Holland II, Ronald",1,81,81,Overall,1.0,197,415,0.475,0.518,0.639,161,265,0.608,0.361,36,150,0.24
201959,"Gibson, Taj",1,37,32,Overall,1.0,47,95,0.495,0.5,0.979,46,93,0.495,0.021,1,2,0.5
203552,"Curry, Seth",1,68,64,Overall,1.0,164,343,0.478,0.599,0.469,81,161,0.503,0.531,83,182,0.456
203994,"Nurkić, Jusuf",1,26,26,Overall,1.0,94,189,0.497,0.532,0.757,81,143,0.566,0.243,13,46,0.283
1628970,"Bridges, Miles",1,64,64,Overall,1.0,469,1089,0.431,0.495,0.587,328,639,0.513,0.413,141,450,0.313
1629610,"Jeffries, DaQuan",1,47,45,Overall,1.0,118,291,0.405,0.5,0.436,63,127,0.496,0.564,55,164,0.335
1630163,"Ball, LaMelo",1,47,47,Overall,1.0,406,1003,0.405,0.494,0.474,227,475,0.478,0.526,179,528,0.339
1630182,"Green, Josh",1,68,68,Overall,1.0,180,421,0.428,0.543,0.411,83,173,0.48,0.589,97,248,0.391
1630585,"Garrett, Marcus",1,4,4,Overall,1.0,11,27,0.407,0.463,0.704,8,19,0.421,0.296,3,8,0.375
1631109,"Williams, Mark",1,44,44,Overall,1.0,270,447,0.604,0.604,0.991,270,443,0.609,0.009,0,4,0.0
1631111,"Moore Jr., Wendell",1,16,16,Overall,1.0,36,76,0.474,0.539,0.645,26,49,0.531,0.355,10,27,0.37
1631217,"Diabaté, Moussa",1,71,65,Overall,1.0,167,280,0.596,0.596,0.979,167,274,0.609,0.021,0,6,0.0
1641733,"Smith Jr., Nick",1,60,59,Overall,1.0,222,568,0.391,0.482,0.461,118,262,0.45,0.539,104,306,0.34
1642275,"Salaün, Tidjane",1,60,60,Overall,1.0,114,345,0.33,0.414,0.406,56,140,0.4,0.594,58,205,0.283
1642354,"Simpson, KJ",1,36,36,Overall,1.0,104,301,0.346,0.4,0.568,71,171,0.415,0.432,33,130,0.254
